═════════════════════════════════════════════════════════════════════
 ░█████╗░░█████╗░███╗░░██╗░██████╗░██████╗░░█████╗░████████╗░██████╗
 ██╔══██╗██╔══██╗████╗░██║██╔════╝░██╔══██╗██╔══██╗╚══██╔══╝██╔════╝
 ██║░░╚═╝██║░░██║██╔██╗██║██║░░██╗░██████╔╝███████║░░░██║░░░╚█████╗░
 ██║░░██╗██║░░██║██║╚████║██║░░╚██╗██╔══██╗██╔══██║░░░██║░░░░╚═══██╗
 ╚█████╔╝╚█████╔╝██║░╚███║╚██████╔╝██║░░██║██║░░██║░░░██║░░░██████╔╝
 ░╚════╝░░╚════╝░╚═╝░░╚══╝░╚═════╝░╚═╝░░╚═╝╚═╝░░╚═╝░░░╚═╝░░░╚═════╝░
═════════════════════════════════════════════════════════════════════