══════════════════════════════════════════════════════════════
 ██╗░░░██╗░█████╗░██╗░░░██╗  ██╗░░░░░░█████╗░░██████╗███████╗
 ╚██╗░██╔╝██╔══██╗██║░░░██║  ██║░░░░░██╔══██╗██╔════╝██╔════╝
 ░╚████╔╝░██║░░██║██║░░░██║  ██║░░░░░██║░░██║╚█████╗░█████╗░░
 ░░╚██╔╝░░██║░░██║██║░░░██║  ██║░░░░░██║░░██║░╚═══██╗██╔══╝░░
 ░░░██║░░░╚█████╔╝╚██████╔╝  ███████╗╚█████╔╝██████╔╝███████╗
 ░░░╚═╝░░░░╚════╝░░╚═════╝░  ╚══════╝░╚════╝░╚═════╝░╚══════╝
══════════════════════════════════════════════════════════════